WWWWWWWWWWWWWWWWWWWW
WooooooooWoooooooooW
WoWWWWoWoWoWoWoWoWoW
WooooooooooooooooooW
WoWWooooWWoWoWoWoWoW
WooooWWoWWoWoWoWoooW
WWWWoWWoWWoWoWoooWoW
WWWWoWWoWWoWoWoWoWoW
WooooooooooooooooooW
WoWoWWoWWoWWoWoWoWoW
WoWoWWoW b WoWoWoooW
WooOWWoWpicWoWoWoWoW
WoWoWWoWWWWWoWoWoooW
WooooooooooooooooWoW
WoWWWoWoWoWWoWWWoWoW
WoWWWoWoWoWWoWWWoWoW
WoooooooooPooooooooW
WoWoWWoWWoWWWoWWoWWW
WoooooooWooooooooooW
WWWWWWWWWWWWWWWWWWWW