WWWWWWWWWWWWWWWWWWWW
WuoooooooWoooooooouW
WoWWWWoWoWoWoWoWoWoW
WooooooooooooooooooW
WoWWooooWWoWoWoWoWoW
WooooWWoWWoWoWoWoooW
WWWWoWWoWWoWoWoooWoW
WWWWoWWoWWoWoWoWoWoW
WooooooooooooooooooW
WoWoWWoWWDWWoWoWoWoW
WoWoWWoW b WoWoWoooW
WooOWWoWpicWoWoWoWoW
WoWAWWoWWWWWoWoWoooW
WooCKSoooooooooooWoW
WoWWWoWoWoWWoWWWoWoW
WoWWWoWoWoWWoWWWoWoW
WoooooooooPooooooooW
WoWoWWoWWoWWWoWWoWoW
WuoooooooooooooooouW
WWWWWWWWWWWWWWWWWWWW