WWWWWWWWWWWWWWWWWWWWWWWWWWWWW
WuooWooooooooWWWooooooooWoouW
WoWooCWWoWWWKoooKWWWoWWOooWoW
WoWoWoooooWooWoWooWoooooWoWoW
WoooWWWWWoWoWWoWWoWoWWWWWoooW
WuWoWoooWoWoooooooWoWoooWoWuW
WoooooWoooooWWDWWoooooWoooooW
WoWoWoWoWoWoW b WoWoWoWoWoWoW
WoooWoooWoooWpicWoooWoooWoooW
WoWWWWoWWoWoWWWWWoWoWWoWWWWoW
WoooooooWoWoACKOSoWoWoooooooW
WWWoWoWoooWWoWoWoWWoooWoWoWWW
WoooooWWoWWWoWoWoWWWoWWoooooW
WoWoWoWWoWWWooPooWWWoWWoWoWoW
WuoooooooooooWWWooooooooPoouW
WWWWWWWWWWWWWWWWWWWWWWWWWWWWW