WWWWWWWWWWWWWWWWWWWWWWWWWWWWW
WuooooooWooWWWWWWWooWoooooouW
WoWWWWWWoWoW     WoWoWWWWWWoW
WoWooWooWooW WWDW WoooWooWooW
WoWoWcWoWWoW  p   WoWWoWbWoWW
WoooWooWooWoWWWWWWoWooWooWooW
WcWWoWWoWWoWoWWWWoWoWWoWWoWWW
WooWooWooWooWooWooWooWooWooWW
WoWWoWWoWWoWWoWWoWWoWWoWWoWWW
WuWooWooWooWoo i WooWooWooWuW
WoWoWWoWWoWWoWWWWoWWoWWoWWoWW
WooWooWooWooWoo c WooWooWooWW
WoooWWWWoWWoWWWWWWoWWoWWWWooW
WoWooWooWooWooAKOSWooWooWooWW
WuooWWWWWWWWoWWWWoWWWWWWWooWu
WWWWWWWWWWWWWWWWWWWWWWWWWWWWW
