WWWWWWWWWWWWWWWWWWWWWWWWWWWWW
WuooooooooooooPoooooooooooouW
WoWWWWWWWWWWWWKWWWWWWWWWWWWoW
WoooooooooooooooooooooooooooW
WoWWWWWWWWWWWWAWWWWWWWWWWWWoW
WoooooooooooooooooooooooooooW
WoWWWWWWWWWoWWDWWoWWWWWWWWWoW
WoWoooWoooWoW b WoWoooWoooWoW
WoooWoooWoooWpicWoooWoooWoooW
WoWWWWWWWWWWWWWWWWWWWWWWWWWoW
WoooooooooooooooooooooooooooW
WoWWWWWWWWWWWWoWWWWWWWWWWWWoW
WoooooooooooooooooooooooooooW
WoWWWWWWWWWWWWCWWWWWWWWWWWWoW
WuooooooooooooPoooooooooooouW
WWWWWWWWWWWWWWWWWWWWWWWWWWWWW